        1111111111111111111111111 111
1110 1111E1111100010000001         101
1100000000110000000000101         111
1111111111111111111111011
100000111
111111111