  111     000     11
00000000000000000001          111
                   1          101
           P        1          111
10001
11111