NO ./textures/path_to_the_north_texture
SO ./path_to_the_south_texture
WE ./path_to_the_west_texture
EA ./path_to_the_east_texture
F 1,2,3
C 3,2,1

11  111  11111           1
     11111N11111111111111111                 
11111      111111