1111111111111111111111111111111
10S011001100110010000000001
1111110000                     1011
01    111                      1111
1111111101111011110111