11111111
001111
0000                      110000000                      11000
0000      S                11000