NO ./textures/path_to_the_north_texture
SO ./path_to_the_south_texture
WE ./path_to_the_west_texture
EA ./path_to_the_east_texture
F 1,2,3
C 3,2,1

    1111111111111111111111111    1111111111111111111111111    1111111111111111111111111
    1000000000110000000000001    1000000000110000000000001    1000000000110000000000001
    1011000001110000000000001    1011000001110000000000001    1011000001110000000000001
    1001000000000000000000001    1001000000000000000000001    1001000000000000000000001
11111111101100000111000000000111111111011000001110000000001111111111101100000111000000011
100000000011000001110111111111000000000110000011101111111111111000000000110000011101111111111111111
111101111111110111000000100011111011111111101110000001000111110111111111011100000010001
111101111111110111010100100011111011111111101110101001000111110111111111011101010010001
110000001101010111000000100011100000011010101110000001000111000000110101011100000010001
100000000000000011000000100011000000000000000110000001000110000000000000001100000010001
100000001000000011010100100011000000010000000110101001000110000000100000001101010010001
11000001110101011111011110N0111000001110101011111011110011111000001010101011111011110011111
11110111 1110101 10111101000111110111 1110101 10111101000111110111 1110101 101111010001
11111111 1111111 11111111111111111111 1111111 11111111111111111111 1111111 111111111111
